###############################
#4                           4#
# # # # # # # # # # # # # # # #
#                             #
# # # # # # # #s# # # # # # # #
#            f   f            #
#4# # # # # # #p# # # # # # #4#
#            b   b            #
# # # # # # # #f# # # # # # # #
#                             #
# # # # # # # # # # # # # # # #
#4                           4#
###############################