###############################
#p    *1 *     *   *  * * *   #
#s# # #*# # #*#*# # # #*#*#*# #
#   x f   ***  *      *   * * #
# # #b# # #*# # #*#*# # # # #*#
#            **  *  *         #
# # # # # # # # # #*# #*# # # #
#*  *      *  *      *        #
# # # # #*# # # #*#*# # # # # #
#*    **  *                   #
# #*# # # # # # #*# # # # # # #
#           *   *  *          #
###############################
